¿Cuánto es?|How much is it?
las cebollas|onions
las judías verdes|green beans
las manzanas|apples
las naranjas|oranges
las peras|pears
lasa zanahorias|carrots
los champiñones|mushrooms
los guisantes|peas
los huevos|eggs
los limones|lemons
los melocotones|peaches
los melones|melons
los pepinos|cucumbers
los pimientos rojos|red peppers
la pimienta|pepper
el sal|salt
los plátanos|bananas
deme|give me
no queda(n)|there are none left
¿Algo más?|anything else?
¿Cuánto es?|how much is it?
nada más|nothing else
medio kilo|half a kilo
una docena de huevos|a dozen eggs
un cartón de leche|carton of milk
un paquete|a packet
azúcar|sugar
arroz|rice
una barra de pan|loaf of bread
una botella de aceite|bottle of oil
una caja de galletas|box of biscuits
una lata de atún|tin of tuna
una pastilla de mantequilla|packet of butter
como|I eat
bebo|I drink
el café|coffee
el cordero|lamb
el pescado|fish
el pollo|chicken
el queso|cheese
el té|tea
el yogur|yoghurt
el zumo|juice
el carne de cerdo|pork
la comida basura|junk food
la comida rápida|fast food
la ensalada|salad
la fruta|fruit
la leche|milk
la lechuga|lettuce
la merluza|hake
la ternera|veal
las gambas|prawns
las tartas con nata|cream cakes
las verduras|green veg
los churros|churros
los dulces|sweets
los filetes|steak
los huevos|eggs
los legumbres|vegetables
los pasteles|cakes
los perritos calientes|hot dogs
contiene|it contains
demasiado|too much
poco|a little
mucho|a lot
la fibra|fibre
la grasa|fat
las proteinas|proteins
las vitaminas|vitamins